ଅଙ୍ଗୁଳି	ax ng g u lx i
ଅଛନ୍	ax ch ax n
ଅଛନ୍ତି	ax ch ax n t i
ଅଛି	ax ch i
ଅଛିକି	ax ch i k i
ଅଛେ	ax ch e
ଅଜନ	ax j ax n a
ଅଜାଣତ	ax j aa nx ax t a
ଅଜାଣତରେ	ax j aa nx ax t ax r e
ଅଜିର୍ଣ	ax j i r nx a
ଅଜ୍ଞା	ax j nj aa
ଅଞ୍ଚଳ	ax nj c ax lx a
ଅଟକି	ax tx ax k i
ଅଠର	ax txh ax r a
ଅଣ୍ଟା	ax nx tx aa
ଅଣ୍ଡକୋଷ	ax nx dx ax k o sx a
ଅଧା	ax dh aa
ଅଧିକ	ax dh i k a
ଅନୁଭବ	ax n u bh ax b a
ଅନ୍ଧାର	ax n dh aa r a
ଅନ୍ଧାରରେ	ax n dh aa r ax r e
ଅନ୍ୟ	ax n y a
ଅପ	ax p a
ଅପେରସନ	ax p e r ax s ax n a
ଅମ୍ବିଳା	ax m b i lx aa
ଅମ୍ଳ	ax m lx a
ଅଲଗା	ax l ax g aa
ଅଲଟ୍ରାସାଉଣ୍ଡ	ax l ax tx r aa s aa u nx dx a
ଅଳ୍ପ	ax lx p a
ଅଶୀ	ax sh ii
ଅସୁବିଧା	ax s u b i dh aa
ଆଇବ	aa i b a
ଆଉ	aa u
ଆଉଥରେ	aa u th ax r e
ଆକାଚାକା	aa k aa c aa k aa
ଆକାରର	aa k aa r ax r a
ଆଖି	aa kh i
ଆଖିକୁ	aa kh i k u
ଆଖିରୁ	aa kh i r u
ଆଖିରେ	aa kh i r e
ଆଗରୁ	aa g ax r u
ଆଂଗୁଳି	aa N g u lx i
ଆଂଗୁଳିଟା	aa N g u lx i tx aa
ଆଗେ	aa g e
ଆଗୋ	aa g o
ଆଙ୍ଗୁଳି	aa ng g u lx i
ଆଜି	aa j i
ଆଜ୍ଞା	aa j nj aa
ଆଠ	aa txh a
ଆଂଠୁ	aa N txh u
ଆଡ୍ମିଶନ	aa dx m i sh ax n a
ଆଣିଥିଲି	aa nx i th i l i
ଆଣ୍ଠୁ	aa nx txh u
ଆଣ୍ଠୁଗଣ୍ଠି	aa nx txh u g ax nx txh i
ଆଦୌ	aa d au
ଆପଣ	aa p ax nx a
ଆପଣଙ୍କ	aa p ax nx ax ng k a
ଆପେ	aa p e
ଆବଶ୍ୟକତା	aa b ax sh y ax k ax t aa
ଆବୁ	aa b u
ଆମ	aa m a
ଆମକୁ	aa m ax k u
ଆମର	aa m ax r a
ଆମେ	aa m e
ଆୟୁଷ	aa y u sx a
ଆର୍.ଏସ୍.ବି.ୱାଇ	aa r e s b i w aa i
ଆର୍.କେ.ବି.ୱାଇ	aa r k e b i w aa i
ଆଶା	aa sh aa
ଆସ	aa s a
ଆସନ୍ତି	aa s ax n t i
ଆସଲା	aa s ax l aa
ଆସିଛି	aa s i ch i
ଆସିଥିନି	aa s i th i n i
ଆସିଥିଲା	aa s i th i l aa
ଆସିବ	aa s i b a
ଆସିବା	aa s i b aa
ଆସିବେ	aa s i b e
ଆସୁଚି	aa s u c i
ଆସୁଛନ୍ତି	aa s u ch ax n t i
ଆସୁଛି	aa s u ch i
ଇଚ୍ଛା	i c ch aa
ଇଛା	i ch aa
ଇଂଜେକସନ	i N j e k ax s ax n a
ଇଞ୍ଚ	i nj c a
ଇଞ୍ଜେକସନ	i nj j e k ax s ax n a
ଇନକ୍ୱାରି	i n ax k w aa r i
ଇନ୍ସୁରାନ୍ସ	i n s u r aa n s a
ଇନ୍ସୁରେନ୍ସ	i n s u r e n s a
ଈଛା	ii ch aa
ଉକା	u k aa
ଉଚ୍ଚ	u c c a
ଉଠା	u txh aa
ଉଠି	u txh i
ଉଠିକି	u txh i k i
ଉଠିବାକୁ	u txh i b aa k u
ଉଠିଲା	u txh i l aa
ଉଠିଲେ	u txh i l e
ଉଠୁଚି	u txh u c i
ଉଠୁଛି	u txh u ch i
ଉଠେଇ	u txh e i
ଉତାପ	u t aa p a
ଉତ୍ତମ	u t t ax m a
ଉତ୍ତାପ	u t t aa p a
ଉନ୍ନତ	u n n ax t a
ଉନ୍ନତି	u n n ax t i
ଉପକାର	u p ax k aa r a
ଉପବାସ	u p ax b aa s a
ଉପଯୁକ୍ତ	u p ax j u k t a
ଉପରକୁ	u p ax r ax k u
ଉପଲବ୍ଧ	u p ax l ax b dh a
ଉର୍ବରତା	u r b ax r ax t aa
ଉଷଦ୍	u sx ax d
ଉଷୁମ	u sx u m a
ଉଷ୍ଧ	u sx dh a
ଋଗ	rq ax g a
ଋତୁ	rq ax t u
ଋତୁଶ୍ରାବ	rq ax t u sh r aa b a
ଋତୁସ୍ରାବ	rq ax t u s r aa b a
ଋପି	rq ax p i
ଏ	e
ଏଇ	e i
ଏଇଠି	e i txh i
ଏଓସିନୋଫିଲିଆ	e o s i n o ph i l i aa
ଏକ	e k a
ଏକର୍	e k ax r
ଏକାଉଣ୍ଟ୍	e k aa u nx tx
ଏ.ଟି.ଏମ୍	e tx i e m
ଏଠାରେ	e txh aa r e
ଏଠି	e txh i
ଏଥିପାଇଁ	e th i p aa i mq
ଏଥିରେ	e th i r e
ଏନଜିଓପ୍ଳାସଟି	e n ax j i o p lx aa s ax tx i
ଏବଂ	e b ax N
ଏବେ	e b e
ଏମ.ଆର.ଆଇ	e m ax aa r ax aa i
ଏମିତି	e m i t i
ଏଲ.ଆଇ.ସି	e l ax aa i s i
ଏଲ୍.ଆଇ.ସି	e l aa i s i
ଏଵଂ	e w ax N
ଏସିଡିଟି	e s i dx i tx i
ଏହା	e h aa
ଏହାକୁ	e h aa k u
ଏହି	e h i
ଓ	o
ଓଜନ	o j ax n a
ଓଷଦ	o sx ax d a
ଓଷଧ	o sx ax dh a
ଔଷଧ	au sx ax dh a
କ	k a
କଅଣ	k ax ax nx a
କଉ	k ax u
କଉଁ	k ax u mq
କଉଠି	k ax u txh i
କଖତ	k ax kh ax t a
କଟ	k ax tx a
କଟକରେ	k ax tx ax k ax r e
କଟା	k ax tx aa
କଟି	k ax tx i
କଟିବ	k ax tx i b a
କଟିଯାଇଥିଲା	k ax tx i j aa i th i l aa
କଟୁଛି	k ax tx u ch i
କଟୁରୀ	k ax tx u r ii
କଂଟ୍ରୋଲ	k ax N tx r o l a
କଣ	k ax nx a
କଣ୍	k ax nx
କଣ୍ଟା	k ax nx tx aa
କଥା	k ax th aa
କଦଳୀପତ୍ର	k ax d ax lx ii p ax t r a
କଫ	k ax ph a
କଫରେ	k ax ph ax r e
କବଳରୁ	k ax b ax lx ax r u
କମ	k ax m a
କମଜୁର	k ax m ax j u r a
କମି	k ax m i
କମିତି	k ax m i t i
କମିଯାଉଛି	k ax m i j aa u ch i
କମିଲା	k ax m i l aa
କମୁଛି	k ax m u ch i
କମୁନି	k ax m u n i
କମେଇବି	k ax m e i b i
କମ୍	k ax m
କମ୍ପ	k ax m p a
କମ୍ପାନୀ	k ax m p aa n ii
କର	k ax r a
କରନ୍ତୁ	k ax r ax n t u
କରା	k ax r aa
କରାଯାଏ	k ax r aa j aa e
କରି	k ax r i
କରିଛନ୍ତି	k ax r i ch ax n t i
କରିଥାନ୍ତି	k ax r i th aa n t i
କରିଥିଲା	k ax r i th i l aa
କରିଥିଲି	k ax r i th i l i
କରିଦଉଛି	k ax r i d ax u ch i
କରିଦେଇ	k ax r i d e i
କରିଦେଉଛି	k ax r i d e u ch i
କରିଦେଲେ	k ax r i d e l e
କରିନାହିଁ	k ax r i n aa h i mq
କରିନି	k ax r i n i
କରିପାରିବ	k ax r i p aa r i b a
କରିପାରିବା	k ax r i p aa r i b aa
କରିପାରିବି	k ax r i p aa r i b i
କରିବା	k ax r i b aa
କରିବାକୁ	k ax r i b aa k u
କରିବି	k ax r i b i
କରିବିକି	k ax r i b i k i
କରିବୁ	k ax r i b u
କରିଲି	k ax r i l i
କରିଵି	k ax r i w i
କରିହେବ	k ax r i h e b a
କରୁଚି	k ax r u c i
କରୁଛନ୍ତି	k ax r u ch ax n t i
କରୁଛି	k ax r u ch i
କରୁନାହିଁ	k ax r u n aa h i mq
କରୁନି	k ax r u n i
କରୁନ୍ତୁ	k ax r u n t u
କରେ	k ax r e
କରୋନା	k ax r o n aa
କଲା	k ax l aa
କଲାଣି	k ax l aa nx i
କଲାବେଳେ	k ax l aa b e lx e
କଲି	k ax l i
କଲେ	k ax l e
କଲ୍ୟାଣ	k ax l y aa nx a
କଳା	k ax lx aa
କଷ୍ଟ	k ax sx tx a
କହନା	k ax h ax n aa
କହି	k ax h i
କହିପାରିବେକି	k ax h i p aa r i b e k i
କହିବାକୁ	k ax h i b aa k u
କହିବେ	k ax h i b e
କହିବେକି	k ax h i b e k i
କହିଲା	k ax h i l aa
କହୁନ	k ax h u n a
କାଉଣ୍ଟର	k aa u nx tx ax r a
କାଗଜ	k aa g ax j a
କାଗଜପତ୍ରର	k aa g ax j ax p ax t r ax r a
କାଚ	k aa c a
କାଞ୍ଚି	k aa nj c i
କାଟି	k aa tx i
କାଟିକି	k aa tx i k i
କାଟିଦିଅନ୍ତୁ	k aa tx i d i ax n t u
କାଟୁଚି	k aa tx u c i
କାଟୁଛି	k aa tx u ch i
କାଟେ	k aa tx e
କାଠ	k aa txh a
କାଣ୍ଡବିନ୍ଧା	k aa nx dx ax b i n dh aa
କାଂଦୁଛି	k aa N d u ch i
କାନ	k aa n a
କାନକୁ	k aa n ax k u
କାନରୁ	k aa n ax r u
କାନରେ	k aa n ax r e
କାନ୍ଦ	k aa n d a
କାନ୍ଦୁଚି	k aa n d u c i
କାନ୍ଦୁଛି	k aa n d u ch i
କାମ	k aa m a
କାମାକ୍ଷାନଗରରେ	k aa m aa k sx aa n ax g ax r ax r e
କାମୁଡି	k aa m u dx i
କାମୁଡ଼ିଲା	k aa m u dxq i l aa
କାମୁଡୁଛି	k aa m u dx u ch i
କାରି	k aa r i
କାର୍ଡ	k aa r dx a
କାର୍ଯ୍ୟ	k aa r j y a
କାର୍ଯ୍ୟକାରି	k aa r j y ax k aa r i
କାଲ	k aa l a
କାଲି	k aa l i
କାଲୁଆ	k aa l u aa
କାଳିଆ	k aa lx i aa
କାଳେ	k aa lx e
କାଶ	k aa sh a
କାଶିଲା	k aa sh i l aa
କାଶିଲେ	k aa sh i l e
କାଶୁଚି	k aa sh u c i
କାସି	k aa s i
କାହାକୁ	k aa h aa k u
କାହିଁ	k aa h i mq
କାହିଁକି	k aa h i mq k i
କି	k i
କିଏ	k i e
କିଛି	k i ch i
କିଛିଦିନ	k i ch i d i n a
କିଛିବି	k i ch i b i
କିଟା	k i tx aa
କିଡନୀ	k i dx ax n ii
କିଡ଼ନୀ	k i dxq ax n ii
କିଣି	k i nx i
କିଣିପାରିବି	k i nx i p aa r i b i
କିଣିବା	k i nx i b aa
କିଣିଲେ	k i nx i l e
କିଣୁଛେ	k i nx u ch e
କିନ୍ତୁ	k i n t u
କିପରି	k i p ax r i
କିମି	k i m i
କିମିତି	k i m i t i
କିଲ	k i l a
କିଲୋ	k i l o
କିଲୋଗ୍ରାମ	k i l o g r aa m a
କିଲୋଗ୍ରାମସ	k i l o g r aa m ax s a
କିଶ	k i sh a
କିଶଟା	k i sh ax tx aa
କିଶମ	k i sh ax m a
କିଷ	k i sx a
କିସ	k i s a
କୁ	k u
କୁଆଡେ	k u aa dx e
କୁଇଣ୍ଟାଲ	k u i nx tx aa l a
କୁକୁର	k u k u r a
କୁଜ	k u j a
କୁଂଡେଇ	k u N dx e i
କୁଣ୍ଡଉଚି	k u nx dx ax u c i
କୁଣ୍ଡାଇ	k u nx dx aa i
କୁଣ୍ଡିଆ	k u nx dx i aa
କୁଣ୍ଡୁଚି	k u nx dx u c i
କୁଣ୍ଡେଇ	k u nx dx e i
କୁନ୍ଥେଇ	k u n th e i
କୁରୁମି	k u r u m i
କୁର୍ମି	k u r m i
କୁହତ	k u h ax t a
କୁହନ୍ତ	k u h ax n t a
କୁହନ୍ତୁ	k u h ax n t u
କୁହେ	k u h e
କୂର୍ମୀ	k uu r m ii
କୃଷକ	k rq sx ax k a
କୃଷି	k rq sx i
କେ	k e
କେଉଁ	k e u mq
କେଉଁଠାକୁ	k e u mq txh aa k u
କେଉଁଠାରୁ	k e u mq txh aa r u
କେଉଁଠାରେ	k e u mq txh aa r e
କେଉଁଠି	k e u mq txh i
କେ.ଏସ୍.ବି.ୱାଇ	k e e s b i w aa i
କେଖାନେ	k e kh aa n e
କେଜାଣି	k e j aa nx i
କେଜାଣେ	k e j aa nx e
କେତ	k e t a
କେତେ	k e t e
କେତେଟଙ୍କା	k e t e tx ax ng k aa
କେତେଦିନ	k e t e d i n a
କେତେବେଳେ	k e t e b e lx e
କେନ୍	k e n
କେବିନ	k e b i n a
କେବିନ୍	k e b i n
କେବେ	k e b e
କେମିତି	k e m i t i
କୋଉ	k o u
କୋଉଠି	k o u txh i
କୋଡ଼ିଏ	k o dxq i e
କୋଲକତା	k o l ax k ax t aa
କୌଣସି	k au nx ax s i
କ୍ୟାନ୍ସର	k y aa n s ax r a
କ୍ଳେମ	k lx e m a
କ୍ଷୀର	k sx ii r a
କ୍ଷୁଦ୍ର	k sx u d r a
ଖଟା	kh ax tx aa
ଖଣ୍ଡିଆ	kh ax nx dx i aa
ଖଦୀୟ	kh ax d ii y a
ଖବର	kh ax b ax r a
ଖରା	kh ax r aa
ଖରାପ	kh ax r aa p a
ଖର୍ଚ	kh ax r c a
ଖର୍ଚ୍ଚ	kh ax r c c a
ଖସ	kh ax s a
ଖସି	kh ax s i
ଖାଇ	kh aa i
ଖାଇକି	kh aa i k i
ଖାଇଛି	kh aa i ch i
ଖାଇତେ	kh aa i t e
ଖାଇପାରୁନାହିଁ	kh aa i p aa r u n aa h i mq
ଖାଇବ	kh aa i b a
ଖାଇବନି	kh aa i b ax n i
ଖାଇବା	kh aa i b aa
ଖାଇବାକୁ	kh aa i b aa k u
ଖାଇବି	kh aa i b i
ଖାଇମି	kh aa i m i
ଖାଇଲା	kh aa i l aa
ଖାଇଲାବେଳକୁ	kh aa i l aa b e lx ax k u
ଖାଇଲାବେଳେ	kh aa i l aa b e lx e
ଖାଇଲାରୁ	kh aa i l aa r u
ଖାଇଲିଣି	kh aa i l i nx i
ଖାଇଲେ	kh aa i l e
ଖାଇସାରିଲା	kh aa i s aa r i l aa
ଖାଇହଉନି	kh aa i h ax u n i
ଖାଉ	kh aa u
ଖାଉଚି	kh aa u c i
ଖାଉଛି	kh aa u ch i
ଖାଉନି	kh aa u n i
ଖାଉଲ୍	kh aa u l
ଖାଁଚୁଛି	kh aa mq c u ch i
ଖାତା	kh aa t aa
ଖାତାରେ	kh aa t aa r e
ଖାଦ୍ଯୟରେ	kh aa d j ax y ax r e
ଖାଦ୍ୟ	kh aa d y a
ଖାନା	kh aa n aa
ଖାନାରେ	kh aa n aa r e
ଖାନ୍ଚି	kh aa n c i
ଖାନ୍ଚୁଚି	kh aa n c u c i
ଖାଲି	kh aa l i
ଖାସ	kh aa s a
ଖିଆ	kh i aa
ଖିର	kh i r a
ଖିଲା	kh i l aa
ଖୁଆ	kh u aa
ଖୁଆଇବାକୁ	kh u aa i b aa k u
ଖୁଲି	kh u l i
ଖୁସି	kh u s i
ଖେଞ୍ଚି	kh e nj c i
ଖେଳୁନି	kh e lx u n i
ଗଟେ	g ax tx e
ଗଂଠି	g ax N txh i
ଗଡି	g ax dx i
ଗଡ଼ି	g ax dxq i
ଗଡିଗଲାଣି	g ax dx i g ax l aa nx i
ଗଡୁଛି	g ax dx u ch i
ଗଡ୍	g ax dx
ଗଣ୍ଠି	g ax nx txh i
ଗତ	g ax t a
ଗତର	g ax t ax r a
ଗଂଧ	g ax N dh a
ଗନ୍ଧ	g ax n dh a
ଗମ	g ax m a
ଗରମ	g ax r ax m a
ଗରିବ	g ax r i b a
ଗର୍ଭ	g ax r bh a
ଗର୍ଭବତୀ	g ax r bh ax b ax t ii
ଗଲା	g ax l aa
ଗଲାଣି	g ax l aa nx i
ଗଲାନି	g ax l aa n i
ଗଲାବେଳେ	g ax l aa b e lx e
ଗଲେ	g ax l e
ଗଳା	g ax lx aa
ଗଳାରେ	g ax lx aa r e
ଗଳୁଚି	g ax lx u c i
ଗଳୁଛି	g ax lx u ch i
ଗାଁ	g aa mq
ଗାଇନେକୋଲୋଜିଷ୍ଟ	g aa i n e k o l o j i sx tx a
ଗାଧୁଆଘରେ	g aa dh u aa gh ax r e
ଗାଲ	g aa l a
ଗିଳିଲା	g i lx i l aa
ଗୀତା	g ii t aa
ଗୁଟେ	g u tx e
ଗୁଡ଼	g u dxq a
ଗୁଡ଼ରେ	g u dxq ax r e
ଗୁଡା	g u dx aa
ଗୁଣ	g u nx a
ଗୁହରେ	g u h ax r e
ଗେଟା	g e tx aa
ଗେଣ୍ଡୁ	g e nx dx u
ଗୋ	g o
ଗୋଟିଏ	g o tx i e
ଗୋଟେ	g o tx e
ଗୋଡ	g o dx a
ଗୋଡ଼	g o dxq a
ଗୋଡ଼	g o dxq a
ଗୋଡ଼ଟା	g o dxq ax tx aa
ଗୋଡର	g o dx ax r a
ଗୋଡ଼ର	g o dxq ax r a
ଗୋଡରେ	g o dx ax r e
ଗୋଡ଼ରେ	g o dxq ax r e
ଗୋଡୋ	g o dx o
ଗୋଲ	g o l a
ଗ୍ୟାସ	g y aa s a
ଗ୍ରୁପ	g r u p a
ଗ୍ରେସ୍	g r e s
ଗ୍ରୋଥ	g r o th a
ଘଟୁଛି	gh ax tx u ch i
ଘଡ	gh ax dx a
ଘନ	gh ax n a
ଘର	gh ax r a
ଘରେ	gh ax r e
ଘଷିଲା	gh ax sx i l aa
ଘଷିଲେ	gh ax sx i l e
ଘା	gh aa
ଘାଆ	gh aa aa
ଘାସ	gh aa s a
ଘିମିରି	gh i m i r i
ଘୁଞ୍ଚି	gh u nj c i
ଘୁରୁଚି	gh u r u c i
ଘୁରୁଛି	gh u r u ch i
ଘୋଳାବିନ୍ଧା	gh o lx aa b i n dh aa
ଙ୍କ	ng k a
ଙ୍କର	ng k ax r a
ଙ୍କୁ	ng k u
ଚକଲେଟ	c ax k ax l e tx a
ଚମକି	c ax m ax k i
ଚର୍ମ	c ax r m a
ଚର୍ମରୋଗ	c ax r m ax r o g a
ଚଲବୁଲା	c ax l ax b u l aa
ଚଲା	c ax l aa
ଚଲାବୁଲା	c ax l aa b u l aa
ଚଳିବ	c ax lx i b a
ଚଳିବକି	c ax lx i b ax k i
ଚାଉଳର	c aa u lx ax r a
ଚାନ୍ଦା	c aa n d aa
ଚାପ	c aa p a
ଚାର	c aa r a
ଚାରା	c aa r aa
ଚାରି	c aa r i
ଚାର୍ଜ	c aa r j a
ଚାଲି	c aa l i
ଚାଲିପାରୁ	c aa l i p aa r u
ଚାଲିପାରୁନାହିଁ	c aa l i p aa r u n aa h i mq
ଚାଲିବାକୁ	c aa l i b aa k u
ଚାଲିଯିବ	c aa l i j i b a
ଚାଲିଲା	c aa l i l aa
ଚାଲିଲେ	c aa l i l e
ଚାଲିହଉନି	c aa l i h ax u n i
ଚାଲୁଚି	c aa l u c i
ଚାଲୁଛି	c aa l u ch i
ଚାଲେ	c aa l e
ଚାଳିଶ	c aa lx i sh a
ଚାଷ	c aa sx a
ଚାଷୀ	c aa sx ii
ଚାହିଁଲା	c aa h i mq l aa
ଚାହିଁଲେ	c aa h i mq l e
ଚାହୁଁଛି	c aa h u mq ch i
ଚାହୁଁଛେ	c aa h u mq ch e
ଚିକିତ୍ସା	c i k i t s aa
ଚିକିସୟା	c i k i s ax y aa
ଚିହ୍ନ	c i h n a
ଚି଼ହ୍ନ	c i h n a
ଚୁଟି	c u tx i
ଚୁଣ୍ଟୁଚି	c u nx tx u c i
ଚେକ	c e k a
ଚେକା	c e k aa
ଚେକ୍	c e k
ଚୋବେଇ	c o b e i
ଛ	ch a
ଛଅ	ch ax ax
ଛଡା	ch ax dx aa
ଛତୁ	ch ax t u
ଛଂଦେଇ	ch ax N d e i
ଛନ୍ତି	ch ax n t i
ଛନ୍ଦିଦେଇ	ch ax n d i d e i
ଛାଟିଲା	ch aa tx i l aa
ଛାଡ଼	ch aa dxq a
ଛାଡିଗଲା	ch aa dx i g ax l aa
ଛାଡ଼ୁ	ch aa dxq u
ଛାଡ଼ୁ	ch aa dxq u
ଛାଡୁ	ch aa dx u
ଛାଡୁନାହିଁ	ch aa dx u n aa h i mq
ଛାଡୁନି	ch aa dx u n i
ଛାତି	ch aa t i
ଛାତିରେ	ch aa t i r e
ଛି	ch i
ଛିଙ୍କ	ch i ng k a
ଛିଟିକା	ch i tx i k aa
ଛିଡା	ch i dx aa
ଛିଡି	ch i dx i
ଛିଣ୍ଡି	ch i nx dx i
ଛିପ	ch i p a
ଛୁଆ	ch u aa
ଛୁଆକୁ	ch u aa k u
ଛୁଆଟା	ch u aa tx aa
ଛୁଆଟାର	ch u aa tx aa r a
ଛୁଆର	ch u aa r a
ଛୁଆର୍	ch u aa r
ଛୁଞ୍ଚି	ch u nj c i
ଛେଚା	ch e c aa
ଛେଡ଼ା	ch e dxq aa
ଛେଦ	ch e d a
ଛୋଟ	ch o tx a
ଜଙ୍ଘରେ	j ax ng gh ax r e
ଜଟିଳ	j ax tx i lx a
ଜଡ଼ି	j ax dxq i
ଜଡ଼ି	j ax dxq i
ଜଣକ	j ax nx ax k a
ଜଣଙ୍କର	j ax nx ax ng k ax r a
ଜଣାଇଲେ	j ax nx aa i l e
ଜଣାପଡ଼ୁନି	j ax nx aa p ax dxq u n i
ଜଣେ	j ax nx e
ଜଣ୍ଡିସ	j ax nx dx i s a
ଜନ୍ଦା	j ax n d aa
ଜମା	j ax m aa
ଜମାରୁ	j ax m aa r u
ଜମି	j ax m i
ଜମିର	j ax m i r a
ଜମିରେ	j ax m i r e
ଜର	j ax r a
ଜରାୟୁ	j ax r aa y u
ଜରୁରୀ	j ax r u r ii
ଜଳ	j ax lx a
ଜଳା	j ax lx aa
ଜଳାପୁଡା	j ax lx aa p u dx aa
ଜଳାପୋଡା	j ax lx aa p o dx aa
ଜଳୁଛି	j ax lx u ch i
ଜୱାଳା	j ax w aa lx aa
ଜାଣତେ	j aa nx ax t e
ଜାଣି	j aa nx i
ଜାଣିପାରୁନି	j aa nx i p aa r u n i
ଜାଣିବା	j aa nx i b aa
ଜାଣିବାକୁ	j aa nx i b aa k u
ଜାଣିବାର	j aa nx i b aa r a
ଜାଣିବି	j aa nx i b i
ଜାଲ	j aa l a
ଜାଲା	j aa l aa
ଜାଲି	j aa l i
ଜିଆ	j i aa
ଜିଆଖତ	j i aa kh ax t a
ଜିଭ	j i bh a
ଜିଭରେ	j i bh ax r e
ଜିମା	j i m aa
ଜିଲ୍ଲାରେ	j i l l aa r e
ଜୀବନ	j ii b ax n a
ଜୁର୍	j u r
ଜୁହାର	j u h aa r a
ଜୋର	j o r a
ଜୋରରେ	j o r ax r e
ଜ୍ଵର	j w ax r a
ଜ୍ୱର	j w ax r a
ଜ୍ୱାଳା	j w aa lx aa
ଝଡି	jh ax dx i
ଝଡୁଚି	jh ax dx u c i
ଝଡୁଛି	jh ax dx u ch i
ଝାଡା	jh aa dx aa
ଝାଡ଼ା	jh aa dxq aa
ଝାଡ଼ା	jh aa dxq aa
ଝାଡ଼ାରେ	jh aa dxq aa r e
ଝାପ୍ସା	jh aa p s aa
ଝାଳ	jh aa lx a
ଝିଅ	jh i ax
ଝିଅର	jh i ax r a
ଝିମଝିମ	jh i m ax jh i m a
ଝିମ୍	jh i m
ଝୁଣ୍ଟି	jh u nx tx i
ଟଂକା	tx ax N k aa
ଟଙ୍କା	tx ax ng k aa
ଟଙ୍କାର	tx ax ng k aa r a
ଟପ୍ଅପ୍	tx ax p ax p
ଟା	tx aa
ଟାଇମ	tx aa i m a
ଟାଣ	tx aa nx a
ଟାଣିଲା	tx aa nx i l aa
ଟାଣୁଛି	tx aa nx u ch i
ଟି	tx i
ଟିକା	tx i k aa
ଟିକିଏ	tx i k i e
ଟିକେ	tx i k e
ଟିଟାନସ	tx i tx aa n ax s a
ଟିଭି	tx i bh i
ଟୀକା	tx ii k aa
ଟେ	tx e
ଟେକି	tx e k i
ଟେନ୍ସନ୍	tx e n s ax n
ଟେଷ୍ଟ	tx e sx tx a
ଟ୍ରାକ୍ଟର	tx r aa k tx ax r a
ଟ୍ରାନ୍ସଫର୍	tx r aa n s ax ph ax r
ଠାରୁ	txh aa r u
ଠିକ	txh i k a
ଠିକସେ	txh i k ax s e
ଠିକ୍	txh i k
ଠେସିକରି	txh e s i k ax r i
ଠେସୁଛି	txh e s u ch i
ଠୋପା	txh o p aa
ଡକ୍ଟର	dx ax k tx ax r a
ଡବଳ	dx ax b ax lx a
ଡର	dx ax r a
ଡାଏବେଟିସ	dx aa e b e tx i s a
ଡାକୁଚି	dx aa k u c i
ଡାକ୍ତର	dx aa k t ax r a
ଡ଼ାକ୍ତର	dxq aa k t ax r a
ଡାକ୍ତରଖାନା	dx aa k t ax r ax kh aa n aa
ଡାହାଣ	dx aa h aa nx a
ଡାହାଣ୍	dx aa h aa nx
ଡିସ୍	dx i s
ଡ଼ୁକରି	dxq u k ax r i
ଡେଥ	dx e th a
ଡେରି	dx e r i
ଡେଲିଭରି	dx e l i bh ax r i
ଡେଲିଭରୀ	dx e l i bh ax r ii
ଡ୍ରେସିଂ	dx r e s i N
ଢିମିକି	dxh i m i k i
ତ	t a
ତଣ୍ଟି	t ax nx tx i
ତର	t ax r a
ତରଫରୁ	t ax r ax ph ax r u
ତଳ	t ax lx a
ତଳକୁ	t ax lx ax k u
ତଳରେ	t ax lx ax r e
ତଳି	t ax lx i
ତଳିପାଦରେ	t ax lx i p aa d ax r e
ତଳିପେଟ	t ax lx i p e tx a
ତଳୁକୁ	t ax lx u k u
ତଳେ	t ax lx e
ତା	t aa
ତାତି	t aa t i
ତାର	t aa r a
ତାରିଖ	t aa r i kh a
ତାହାଲେ	t aa h aa l e
ତିନ	t i n a
ତିନି	t i n i
ତିନିଟା	t i n i tx aa
ତିନ୍	t i n
ତିରିଶ	t i r i sh a
ତୁଇ	t u i
ତୁଳନାରେ	t u lx ax n aa r e
ତେଣୁ	t e nx u
ତେତିଶ	t e t i sh a
ତେଲ	t e l a
ଥକା	th ax k aa
ଥକ୍କା	th ax k k aa
ଥଣ୍ଡା	th ax nx dx aa
ଥଣ୍ଡାରେ	th ax nx dx aa r e
ଥର	th ax r a
ଥରୁଚି	th ax r u c i
ଥରୁଛି	th ax r u ch i
ଥରେ	th ax r e
ଥାଆନ୍ତି	th aa aa n t i
ଥାଇତି	th aa i t i
ଥାଇରଏଡ଼	th aa i r ax e dxq a
ଥାନ୍ତି	th aa n t i
ଥିଲା	th i l aa
ଥିଲେ	th i l e
ଦଉଚି	d ax u c i
ଦଉଛି	d ax u ch i
ଦଉନାହାନ୍ତି	d ax u n aa h aa n t i
ଦଉନି	d ax u n i
ଦଖାଇବି	d ax kh aa i b i
ଦବାକୁ	d ax b aa k u
ଦବାପାଇଁ	d ax b aa p aa i mq
ଦମ	d ax m a
ଦମ୍ଭ	d ax m bh a
ଦୟାକରି	d ax y aa k ax r i
ଦରକାର	d ax r ax k aa r a
ଦରଜ	d ax r ax j a
ଦଲାଲ୍	d ax l aa l
ଦଳି	d ax lx i
ଦଶ	d ax sh a
ଦାଗ	d aa g a
ଦାନ୍ତ	d aa n t a
ଦାନ୍ତରୁ	d aa n t ax r u
ଦାନ୍ତରେ	d aa n t ax r e
ଦାମ୍	d aa m
ଦିଅ	d i ax
ଦିଅନ୍ତୁ	d i ax n t u
ଦିଆ	d i aa
ଦିଆଉନ୍ତୁ	d i aa u n t u
ଦିଆଯାଉଛି	d i aa j aa u ch i
ଦିଇଟା	d i i tx aa
ଦିଟା	d i tx aa
ଦିଦି	d i d i
ଦିନ	d i n a
ଦିନକୁ	d i n ax k u
ଦିନରେ	d i n ax r e
ଦିନହେଲା	d i n ax h e l aa
ଦିଶୁଚି	d i sh u c i
ଦିଶୁଛି	d i sh u ch i
ଦିଶୁନି	d i sh u n i
ଦିସୁନି	d i s u n i
ଦିହ	d i h a
ଦିହରୁ	d i h ax r u
ଦିହରେ	d i h ax r e
ଦିହସାରା	d i h ax s aa r aa
ଦୁଇ	d u i
ଦୁଇଟା	d u i tx aa
ଦୁଇଟି	d u i tx i
ଦୁଇଥର	d u i th ax r a
ଦୁଇରୁ	d u i r u
ଦୁର୍ଗନ୍ଧ	d u r g ax n dh a
ଦୁର୍ବଳ	d u r b ax lx a
ଦୁର୍ଵଳିଆ	d u r w ax lx i aa
ଦୁଶୁନି	d u sh u n i
ଦେ	d e
ଦେଇ	d e i
ଦେଇକି	d e i k i
ଦେଇଛି	d e i ch i
ଦେଇଥିଲା	d e i th i l aa
ଦେଉଛି	d e u ch i
ଦେଖ	d e kh a
ଦେଖଉଛି	d e kh ax u ch i
ଦେଖନ୍ତୁ	d e kh ax n t u
ଦେଖା	d e kh aa
ଦେଖାଇ	d e kh aa i
ଦେଖାଇବି	d e kh aa i b i
ଦେଖାମି	d e kh aa m i
ଦେଖାଯାଉଛି	d e kh aa j aa u ch i
ଦେଖି	d e kh i
ଦେଖିକି	d e kh i k i
ଦେଖିଥାନ୍ତି	d e kh i th aa n t i
ଦେଖିବା	d e kh i b aa
ଦେଖିବେ	d e kh i b e
ଦେଖୁ	d e kh u
ଦେଖୁଚି	d e kh u c i
ଦେଖୁଛନ୍ତ	d e kh u ch ax n t a
ଦେଖୁଛନ୍ତି	d e kh u ch ax n t i
ଦେଖୁନ	d e kh u n a
ଦେଖେଇ	d e kh e i
ଦେଖେଇବି	d e kh e i b i
ଦେଖେଇମି	d e kh e i m i
ଦେଖେଇଲୁ	d e kh e i l u
ଦେଖେଇଲେ	d e kh e i l e
ଦେଖେବି	d e kh e b i
ଦେଢ଼	d e dxhq a
ଦେବାକୁ	d e b aa k u
ଦେୟ	d e y a
ଦେଲା	d e l aa
ଦେଲେ	d e l e
ଦେହ	d e h a
ଦେହଟା	d e h ax tx aa
ଦେହର	d e h ax r a
ଦେହରୁ	d e h ax r u
ଦେହରେ	d e h ax r e
ଦେହେ	d e h e
ଦୋଷ	d o sx a
ଦ୍ଵାର	d w aa r a
ଦ୍ୱାର	d w aa r a
ଧଇଁ	dh ax i mq
ଧଇଁସଇଁ	dh ax i mq s ax i mq
ଧରି	dh ax r i
ଧରିଛି	dh ax r i ch i
ଧଳା	dh ax lx aa
ଧାନ	dh aa n a
ଧାନର	dh aa n ax r a
ଧୁଁଆଳିଆ	dh u mq aa lx i aa
ନ	n a
ନଅ	n ax ax
ନଖ	n ax kh a
ନଥିଲି	n ax th i l i
ନବା	n ax b aa
ନବେ	n ax b e
ନମ୍ବର	n ax m b ax r a
ନର୍ମାଲ	n ax r m aa l a
ନଷ୍ଟ	n ax sx tx a
ନହେଲେ	n ax h e l e
ନା	n aa
ନାଁ	n aa mq
ନାଇଁ	n aa i mq
ନାକ	n aa k a
ନାକରୁ	n aa k ax r u
ନାଗୁଚି	n aa g u c i
ନାତି	n aa t i
ନାଲି	n aa l i
ନାଳ	n aa lx a
ନାହି	n aa h i
ନାହିଁ	n aa h i mq
ନିଏ	n i e
ନିଜ	n i j a
ନିଦ	n i d a
ନିର୍ଦ୍ଧିଷ୍ଟ	n i r d dh i sx tx a
ନିଃଶ୍ବାସ	n i hq sh b aa s a
ନିଶ୍ଵାସ	n i sh w aa s a
ନିଃଶ୍ୱାସ	n i hq sh w aa s a
ନିଶ୍ୱାସ	n i sh w aa s a
ନିସେଇ	n i s e i
ନିସ୍ତେଜ	n i s t e j a
ନିହାତି	n i h aa t i
ନୁନୁ	n u n u
ନେଇ	n e i
ନେଇକି	n e i k i
ନେଇଥିଲି	n e i th i l i
ନେଇପାରୁନି	n e i p aa r u n i
ନେଇଯାଇଥିବ	n e i j aa i th i b a
ନେଇଯିବ	n e i j i b a
ନେଉ	n e u
ନେଉଟି	n e u tx i
ନେଗେଟିଭ	n e g e tx i bh a
ନେବାକୁ	n e b aa k u
ନେବାର	n e b aa r a
ନେବାରେ	n e b aa r e
ନେବି	n e b i
ନେବିକି	n e b i k i
ନେବେ	n e b e
ନେଲା	n e l aa
ନେଳି	n e lx i
ପଇଠ	p ax i txh a
ପଇଂତିରିଶ	p ax i N t i r i sh a
ପଇସା	p ax i s aa
ପକଉଛି	p ax k ax u ch i
ପକାଇବ	p ax k aa i b a
ପକାଇବା	p ax k aa i b aa
ପକାଉଛି	p ax k aa u ch i
ପଖକେ	p ax kh ax k e
ପଚାଶ	p ax c aa sh a
ପଚି	p ax c i
ପଚିଶ	p ax c i sh a
ପଚିଶି	p ax c i sh i
ପଚୁଛି	p ax c u ch i
ପଞ୍ଚଚାଳିଶି	p ax nj c ax c aa lx i sh i
ପଞ୍ଚଷଠି	p ax nj c ax sx ax txh i
ପଞ୍ଚାବନ	p ax nj c aa b ax n a
ପଟ	p ax tx a
ପଟାରେ	p ax tx aa r e
ପଠେଇ	p ax txh e i
ପଠେଇଚି	p ax txh e i c i
ପଠେଇବାର	p ax txh e i b aa r a
ପଠେଇଲା	p ax txh e i l aa
ପଡି	p ax dx i
ପଡ଼ି	p ax dxq i
ପଡିକି	p ax dx i k i
ପଡ଼ିଗଲି	p ax dxq i g ax l i
ପଡିବ	p ax dx i b a
ପଡ଼ିବ	p ax dxq i b a
ପଡିବକି	p ax dx i b ax k i
ପଡିଯାଇଛି	p ax dx i j aa i ch i
ପଡିଯାଇଥିଲା	p ax dx i j aa i th i l aa
ପଡିଯାଇଥିଲି	p ax dx i j aa i th i l i
ପଡିଯାଉଛି	p ax dx i j aa u ch i
ପଡିଲା	p ax dx i l aa
ପଡ଼ିଲି	p ax dxq i l i
ପଡୁଛନ୍ତି	p ax dx u ch ax n t i
ପଡ଼ୁଛି	p ax dxq u ch i
ପଡ଼ୁଛି	p ax dxq u ch i
ପଡୁଛି	p ax dx u ch i
ପଡୁଛୁ	p ax dx u ch u
ପଢି	p ax dxh i
ପଢ଼ିବା	p ax dxhq i b aa
ପଢିଲେ	p ax dxh i l e
ପଢ଼ୁଛି	p ax dxhq u ch i
ପତ	p ax t a
ପତନ	p ax t ax n a
ପତଲା	p ax t ax l aa
ପତଳା	p ax t ax lx aa
ପତ୍ର	p ax t r a
ପଥର	p ax th ax r a
ପଥୁରୀ	p ax th u r ii
ପନ୍ଦର	p ax n d ax r a
ପରି	p ax r i
ପରିକ୍ଷା	p ax r i k sx aa
ପରିବା	p ax r i b aa
ପରିବୋ	p ax r i b o
ପରିଶ୍ରା	p ax r i sh r aa
ପରିସ୍କାର	p ax r i s k aa r a
ପରିସ୍ରା	p ax r i s r aa
ପରୀକ୍ଷା	p ax r ii k sx aa
ପରେ	p ax r e
ପର୍ଯ୍ୟନ୍ତ	p ax r j y ax n t a
ପଳା	p ax lx aa
ପଶି	p ax sh i
ପଶିଯାଇ	p ax sh i j aa i
ପଶିଯାଇଛି	p ax sh i j aa i ch i
ପସିଚି	p ax s i c i
ପାଇ	p aa i
ପାଇଁ	p aa i mq
ପାଇନି	p aa i n i
ପାଇପାରିବି	p aa i p aa r i b i
ପାଇବା	p aa i b aa
ପାଇବି	p aa i b i
ପାଇବୁ	p aa i b u
ପାଈଁ	p aa ii mq
ପାଈବା	p aa ii b aa
ପାଉନି	p aa u n i
ପାଖ	p aa kh a
ପାଖକୁ	p aa kh ax k u
ପାଖରେ	p aa kh ax r e
ପାଚି	p aa c i
ପାଚିଯାଇଛି	p aa c i j aa i ch i
ପାଚୁଛି	p aa c u ch i
ପାଚେରୀରୁ	p aa c e r ii r u
ପାଛି	p aa ch i
ପାଞ୍ଚ	p aa nj c a
ପାଞ୍ଚରୁ	p aa nj c ax r u
ପାଟି	p aa tx i
ପାଟିରୁ	p aa tx i r u
ପାଟିରେ	p aa tx i r e
ପାଠ	p aa txh a
ପାଠରେ	p aa txh ax r e
ପାଣି	p aa nx i
ପାଦ	p aa d a
ପାଦରେ	p aa d ax r e
ପାନକ୍ରିଆସ	p aa n ax k r i aa s a
ପାପୁଲି	p aa p u l i
ପାରିଜାତ	p aa r i j aa t a
ପାରିବ	p aa r i b a
ପାରିବନାହିଁ	p aa r i b ax n aa h i mq
ପାରିବା	p aa r i b aa
ପାରିବି	p aa r i b i
ପାରିବେ	p aa r i b e
ପାରୁ	p aa r u
ପାରୁନାହଁ	p aa r u n aa h ax mq
ପାରୁନାହିଁ	p aa r u n aa h i mq
ପାରୁନି	p aa r u n i
ପାଲଟିଛି	p aa l ax tx i ch i
ପାଳନ	p aa lx ax n a
ପାସବୁକ୍	p aa s ax b u k
ପିଇ	p i i
ପିଇଲେ	p i i l e
ପିଛା	p i ch aa
ପିଠି	p i txh i
ପିଠିରେ	p i txh i r e
ପିତକୋଷ	p i t ax k o sx a
ପିରିଅଡ଼	p i r i ax dxq a
ପିରିୟଡ଼	p i r i y ax dxq a
ପିରୀଅଡ଼	p i r ii ax dxq a
ପିରୀଅଡ଼ସ	p i r ii ax dxq ax s a
ପିଲା	p i l aa
ପିଲାକୁ	p i l aa k u
ପିଲାଟି	p i l aa tx i
ପିଲାପିଲି	p i l aa p i l i
ପିଲାର	p i l aa r a
ପୀଡା	p ii dx aa
ପୁଅ	p u ax
ପୁଅର	p u ax r a
ପୁକ	p u k a
ପୁଜ	p u j a
ପୁଟୁକା	p u tx u k aa
ପୁଡୁଚି	p u dx u c i
ପୁଡୁଛି	p u dx u ch i
ପୁଣି	p u nx i
ପୁରା	p u r aa
ପୁରୁଣା	p u r u nx aa
ପୂଜ	p uu j a
ପୂର୍ବ	p uu r b a
ପୂର୍ବରୁ	p uu r b ax r u
ପେ	p e
ପେଜ	p e j a
ପେଟ	p e tx a
ପେଟବଡ଼	p e tx ax b ax dxq a
ପେଟରେ	p e tx ax r e
ପେନ	p e n a
ପେନସନ	p e n ax s ax n a
ପେନ୍	p e n
ପେମେଣ୍ଟ	p e m e nx tx a
ପେରାଲିଶିଶ	p e r aa l i sh i sh a
ପେଶୀ	p e sh ii
ପେଷି	p e sx i
ପୈଠ	p ai txh a
ପୈତିରିଶ	p ai t i r i sh a
ପୋକ	p o k a
ପୋଖରୀରେ	p o kh ax r ii r e
ପୋଜିଟିଭ	p o j i tx i bh a
ପୋଡା	p o dx aa
ପୋଡୁଛି	p o dx u ch i
ପୋଲିଓ	p o l i o
ପୋସିଟିଭ	p o s i tx i bh a
ପ୍ରକାର	p r ax k aa r a
ପ୍ରକୃତରେ	p r ax k rq t ax r e
ପ୍ରଧାନମନ୍ତ୍ରୀ	p r ax dh aa n ax m ax n t r ii
ପ୍ରବଳ	p r ax b ax lx a
ପ୍ରୟୋଗ	p r ax y o g a
ପ୍ରସବ	p r ax s ax b a
ପ୍ରସଵ	p r ax s ax w a
ପ୍ରସ୍ତୁତ	p r ax s t u t a
ପ୍ରାୟ	p r aa y a
ପ୍ରେଗନାଂଟ	p r e g ax n aa N tx a
ପ୍ରେଗନେନସି	p r e g ax n e n ax s i
ପ୍ରେଗ୍ନନ୍ସି	p r e g n ax n s i
ପ୍ରେସକ୍ରିପଶନ	p r e s ax k r i p ax sh ax n a
ପ୍ରେସର	p r e s ax r a
ପ୍ରୋୟାଗ	p r o y aa g a
ଫମ୍ପେଇଲା	ph ax m p e i l aa
ଫର୍ମ	ph ax r m a
ଫଳି	ph ax lx i
ଫସଲ	ph ax s ax l a
ଫସଲର	ph ax s ax l ax r a
ଫାଟିଗଲା	ph aa tx i g ax l aa
ଫାମ୍ପି	ph aa m p i
ଫାମ୍ପିଯାଉଛି	ph aa m p i j aa u ch i
ଫାମ୍ପିଲା	ph aa m p i l aa
ଫାଳିଆ	ph aa lx i aa
ଫିବର	ph i b ax r a
ଫୁଟିଲା	ph u tx i l aa
ଫୁଟୁକା	ph u tx u k aa
ଫୁଡିଲା	ph u dx i l aa
ଫୁନ	ph u n a
ଫୁଲ	ph u l a
ଫୁଲି	ph u l i
ଫୁଲିକି	ph u l i k i
ଫୁଲିଚି	ph u l i c i
ଫୁଲିଯାଇଛି	ph u l i j aa i ch i
ଫୁଲିଯାଉଛି	ph u l i j aa u ch i
ଫୁଲୁଚି	ph u l u c i
ଫୁଲୁଛି	ph u l u ch i
ଫେଣ	ph e nx a
ଫୋଟକା	ph o tx ax k aa
ଫୋନ୍	ph o n
ଫ୍ରି	ph r i
ବଚତ	b ax c ax t a
ବଜାର	b ax j aa r a
ବଞ୍ଚି	b ax nj c i
ବଡ	b ax dx a
ବଡ଼	b ax dxq a
ବଡ଼	b ax dxq a
ବଡେ	b ax dx e
ବଢ଼ା	b ax dxhq aa
ବଢି	b ax dxh i
ବଢ଼ି	b ax dxhq i
ବଢ଼ିଚି	b ax dxhq i c i
ବଢିବ	b ax dxh i b a
ବଢିଯାଇଛି	b ax dxh i j aa i ch i
ବଢ଼ିଯାଇଛି	b ax dxhq i j aa i ch i
ବଢୁଛି	b ax dxh u ch i
ବଢୁନାହିଁ	b ax dxh u n aa h i mq
ବଢୁନି	b ax dxh u n i
ବଣାଇନାହିଁ	b ax nx aa i n aa h i mq
ବଥା	b ax th aa
ବଂଦ	b ax N d a
ବଧିରା	b ax dh i r aa
ବଧେ	b ax dh e
ବନ୍ଦ	b ax n d a
ବନ୍ଦହେଇଯାଇଛି	b ax n d ax h e i j aa i ch i
ବୟସ	b ax y ax s a
ବୟସର	b ax y ax s ax r a
ବୟସ୍କା	b ax y ax s k aa
ବର୍ତ୍ତମାନ	b ax r t t ax m aa n a
ବର୍ଷ	b ax r sx a
ବର୍ଷକୁ	b ax r sx ax k u
ବର୍ଷର	b ax r sx ax r a
ବର୍ଷା	b ax r sx aa
ବର୍ଷେ	b ax r sx e
ବଳ	b ax lx a
ବସା	b ax s aa
ବସି	b ax s i
ବସିଉଠି	b ax s i u txh i
ବସିକି	b ax s i k i
ବସୁଛନ୍ତି	b ax s u ch ax n t i
ବସୁଛି	b ax s u ch i
ବସୁନି	b ax s u n i
ବହି	b ax h i
ବହୁଛି	b ax h u ch i
ବହୁତ	b ax h u t a
ବହୁତୁ	b ax h u t u
ବହୁତ୍	b ax h u t
ବା	b aa
ବାଆଁ	b aa aa mq
ବାଇଶି	b aa i sh i
ବାକୁ	b aa k u
ବାଜି	b aa j i
ବାଜିଛି	b aa j i ch i
ବାଟ	b aa tx a
ବାଟେ	b aa tx e
ବାଡ଼ି	b aa dxq i
ବାତ	b aa t a
ବାଂଧୁଛି	b aa N dh u ch i
ବାଧ୍ୟ	b aa dh y a
ବାନ୍ତି	b aa n t i
ବାନ୍ଧୁଛି	b aa n dh u ch i
ବାପା	b aa p aa
ବାପାଙ୍କର	b aa p aa ng k ax r a
ବାମ	b aa m a
ବାମପାଖ	b aa m ax p aa kh a
ବାରମ୍ବାର	b aa r ax m b aa r a
ବାର୍	b aa r
ବାଲାନ୍ସ	b aa l aa n s a
ବାଳ	b aa lx a
ବାସୁଛି	b aa s u ch i
ବାହା	b aa h aa
ବାହାଘର	b aa h aa gh ax r a
ବାହାଘରକୁ	b aa h aa gh ax r ax k u
ବାହାରି	b aa h aa r i
ବାହାରିଛି	b aa h aa r i ch i
ବାହାରିବ	b aa h aa r i b a
ବାହାରିଯାଉଛି	b aa h aa r i j aa u ch i
ବାହାରିଲା	b aa h aa r i l aa
ବାହାରୁ	b aa h aa r u
ବାହାରୁଚି	b aa h aa r u c i
ବାହାରୁଛି	b aa h aa r u ch i
ବାହାରେ	b aa h aa r e
ବି	b i
ବିକୁଛି	b i k u ch i
ବିକ୍ରି	b i k r i
ବିକ୍ରୀ	b i k r ii
ବିଛଣା	b i ch ax nx aa
ବିଛଣାରୁ	b i ch ax nx aa r u
ବିଛଣାରେ	b i ch ax nx aa r e
ବିଜୁ	b i j u
ବିଞ୍ଛାଇ	b i nj ch aa i
ବିଦ୍ୟୁତ	b i d y u t a
ବିଂଧା	b i N dh aa
ବିନ୍ଧା	b i n dh aa
ବିନ୍ଧୁଚି	b i n dh u c i
ବିନ୍ଧୁଛି	b i n dh u ch i
ବି.ପି	b i p i
ବିଭାଗ	b i bh aa g a
ବିମାରେ	b i m aa r e
ବିଲ	b i l a
ବିଲ୍	b i l
ବିଷୟ	b i sx ax y a
ବିଷୟରେ	b i sx ax y ax r e
ବୀମା	b ii m aa
ବୀର୍ଯ୍ୟ	b ii r j y a
ବୁଜି	b u j i
ବୁଝାଇଦିଅନ୍ତୁ	b u jh aa i d i ax n t u
ବୁଡି	b u dx i
ବୁଡ଼ି	b u dxq i
ବୁଲଉଛି	b u l ax u ch i
ବୁଲା	b u l aa
ବୁଲାଇ	b u l aa i
ବୁଲାଇବା	b u l aa i b aa
ବୁଲାଉଛି	b u l aa u ch i
ବୁଲି	b u l i
ବୁଲୁ	b u l u
ବୁଲୁଚି	b u l u c i
ବୁଲୁଛି	b u l u ch i
ବୁଲୁନି	b u l u n i
ବୁଲେଇ	b u l e i
ବୁଲେଛି	b u l e ch i
ବୁଲୋଉଛି	b u l o u ch i
ବୃଦ୍ଧ	b rq d dh a
ବେକରେ	b e k ax r e
ବେଙ୍କ	b e ng k a
ବେଡେ	b e dx e
ବେଲେ	b e l e
ବେଳ	b e lx a
ବେଳକୁ	b e lx ax k u
ବେଳେ	b e lx e
ବେଳେବେଳେ	b e lx e b e lx e
ବେଶି	b e sh i
ବେଶୀ	b e sh ii
ବେସି	b e s i
ବେହୋସ	b e h o s a
ବୋଲି	b o l i
ବୋହୁଛି	b o h u ch i
ବ୍ୟଥା	b y ax th aa
ବ୍ୟବସ୍ଥା	b y ax b ax s th aa
ବ୍ୟବହାର	b y ax b ax h aa r a
ବ୍ୟବହୃତ	b y ax b ax h rq t a
ବ୍ୟାଙ୍କ	b y aa ng k a
ବ୍ୟାଙ୍କ୍	b y aa ng k
ବ୍ରଣ	b r ax nx a
ବ୍ରତ	b r ax t a
ବ୍ଲଡ଼	b l ax dxq a
ବ୍ଲିଡ଼ିଙ୍ଗ	b l i dxq i ng g a
ଭଙ୍ଗି	bh ax ng g i
ଭର୍ତି	bh ax r t i
ଭର୍ତ୍ତିହେଲେ	bh ax r t t i h e l e
ଭଲ	bh ax l a
ଭଲରେ	bh ax l ax r e
ଭଳି	bh ax lx i
ଭଳିଆ	bh ax lx i aa
ଭା	bh aa
ଭାଁ	bh aa mq
ଭାଆ	bh aa aa
ଭାଙ୍ଗି	bh aa ng g i
ଭାଙ୍ଗୁଛି	bh aa ng g u ch i
ଭାତ	bh aa t a
ଭାବ	bh aa b a
ଭାବରେ	bh aa b ax r e
ଭାବୁଛି	bh aa b u ch i
ଭାବେ	bh aa b e
ଭାରି	bh aa r i
ଭିଟାମିନ	bh i tx aa m i n a
ଭିତରେ	bh i t ax r e
ଭିନ୍ନ	bh i n n a
ଭିଷଣ	bh i sx ax nx a
ଭୀଷଣ	bh ii sx ax nx a
ଭୁକ	bh u k a
ଭୁତ	bh u t a
ଭୂତ	bh uu t a
ଭେଷଜର	bh e sx ax j ax r a
ଭୋକ	bh o k a
ମଛକି	m ax ch ax k i
ମଝିଆ	m ax jh i aa
ମଝିରେ	m ax jh i r e
ମଞ୍ଜି	m ax nj j i
ମତେ	m ax t e
ମଥା	m ax th aa
ମଧୁମେହ	m ax dh u m e h a
ମଧ୍ୟ	m ax dh y a
ମଧ୍ୟ୍ୟ	m ax dh y y a
ମନ	m ax n a
ମନେ	m ax n e
ମର	m ax r a
ମରା	m ax r aa
ମରିକିନା	m ax r i k i n aa
ମଳକଣ୍ଟକ	m ax lx ax k ax nx tx ax k a
ମଶା	m ax sh aa
ମା	m aa
ମାଆଙ୍କର	m aa aa ng k ax r a
ମାଆଙ୍କୁ	m aa aa ng k u
ମାଗଣା	m aa g ax nx aa
ମାଛ	m aa ch a
ମାଛଆଖି	m aa ch ax aa kh i
ମାଛିଆ	m aa ch i aa
ମାଟି	m aa tx i
ମାଡ	m aa dx a
ମାଡ଼	m aa dxq a
ମାଡ଼	m aa dxq a
ମାଢି	m aa dxh i
ମାଢ଼ି	m aa dxhq i
ମାଢ଼ିରୁ	m aa dxhq i r u
ମାଢ଼ୀ	m aa dxhq ii
ମାତ୍ର	m aa t r a
ମାତ୍ରକେ	m aa t r ax k e
ମାନଙ୍କ	m aa n ax ng k a
ମାନଙ୍କୁ	m aa n ax ng k u
ମାନର	m aa n ax r a
ମାନେ	m aa n e
ମାପ	m aa p a
ମାପି	m aa p i
ମାପିଦିଅ	m aa p i d i ax
ମାପିବ	m aa p i b a
ମାର	m aa r a
ମାରି	m aa r i
ମାରିବା	m aa r i b aa
ମାରିଯାଉଛି	m aa r i j aa u ch i
ମାରୁଚି	m aa r u c i
ମାଂସ	m aa N s a
ମାସ	m aa s a
ମାସକରେ	m aa s ax k ax r e
ମାସର	m aa s ax r a
ମାସରେ	m aa s ax r e
ମାସିକା	m aa s i k aa
ମାସିକିଆ	m aa s i k i aa
ମାସୁଆରି	m aa s u aa r i
ମିଛ	m i ch a
ମିଲେକି	m i l e k i
ମିଳା	m i lx aa
ମିଳାମିଶା	m i lx aa m i sh aa
ମିଳି	m i lx i
ମିଳିପାରିବ	m i lx i p aa r i b a
ମିଳିବ	m i lx i b a
ମିଳିବେ	m i lx i b e
ମିଳିଯିବ	m i lx i j i b a
ମିଳେ	m i lx e
ମିଶା	m i sh aa
ମୁ	m u
ମୁଁ	m u mq
ମୁଇ	m u i
ମୁଇଁ	m u i mq
ମୁକୁଳିଵି	m u k u lx i w i
ମୁଗ	m u g a
ମୁଟା	m u tx aa
ମୁଂଡ	m u N dx a
ମୁଡି	m u dx i
ମୁଣ୍ଡ	m u nx dx a
ମୁଣ୍ଡଟା	m u nx dx ax tx aa
ମୁଣ୍ଡର	m u nx dx ax r a
ମୁଣ୍ଡରୁ	m u nx dx ax r u
ମୁଣ୍ଡରେ	m u nx dx ax r e
ମୁଣ୍ଡା	m u nx dx aa
ମୁତ	m u t a
ମୁତିଲା	m u t i l aa
ମୁତୁଛି	m u t u ch i
ମୁତ୍ରରୋଗ	m u t r ax r o g a
ମୁର୍ଚ୍ଛା	m u r c ch aa
ମୁଲ୍ଯରେ	m u l j ax r e
ମୁହଁ	m u h ax mq
ମୁଁହ	m u mq h a
ମୁହଁରେ	m u h ax mq r e
ମୁଁହରେ	m u mq h ax r e
ମୂଲ୍ଯରେ	m uu l j ax r e
ମେଡ଼ାମ	m e dxq aa m a
ମେଡିକାଲ	m e dx i k aa l a
ମେଡିସିନ	m e dx i s i n a
ମେଡ଼ିସିନ	m e dxq i s i n a
ମେନ୍ସ	m e n s a
ମେନ୍ସେସ	m e n s e s a
ମେସିନ୍	m e s i n
ମୋ	m o
ମୋଟା	m o tx aa
ମୋଡି	m o dx i
ମୋଡ଼ି	m o dxq i
ମୋତେ	m o t e
ମୋଥା	m o th aa
ମୋବାଇଲ	m o b aa i l a
ମୋବାଇଲ୍	m o b aa i l
ମୋର	m o r a
ମୋରୋ	m o r o
ମୋର୍	m o r
ଯଦି	j ax d i
ଯନ୍ତ୍ରଣା	j ax n t r ax nx aa
ଯନ୍ତ୍ରପାତି	j ax n t r ax p aa t i
ଯାଇ	j aa i
ଯାଇଁ	j aa i mq
ଯାଇଛ	j aa i ch a
ଯାଇଛି	j aa i ch i
ଯାଇଥିଲା	j aa i th i l aa
ଯାଈଥିନି	j aa ii th i n i
ଯାଉ	j aa u
ଯାଉଚି	j aa u c i
ଯାଉଛି	j aa u ch i
ଯାଉଥିଲା	j aa u th i l aa
ଯାଉନି	j aa u n i
ଯାଏ	j aa e
ଯାଏଁ	j aa e mq
ଯାକ	j aa k a
ଯାହା	j aa h aa
ଯିବ	j i b a
ଯିବା	j i b aa
ଯିବାକୁ	j i b aa k u
ଯୁଜୁନା	j u j u n aa
ଯେ	j e
ଯେଉଁ	j e u mq
ଯେତେ	j e t e
ଯେହେତୁ	j e h e t u
ଯୋଜନା	j o j ax n aa
ଯୋଜନାରେ	j o j ax n aa r e
ୟା	y aa
ୟୁଜ଼	y u jq a
ର	r a
ରକ୍ତ	r ax k t a
ରକ୍ଷାପାଇ	r ax k sx aa p aa i
ରଖିଛି	r ax kh i ch i
ରଖୁଛି	r ax kh u ch i
ରଙ୍ଗର	r ax ng g ax r a
ରହଛି	r ax h ax ch i
ରହିଛି	r ax h i ch i
ରହିଛିକି	r ax h i ch i k i
ରହିବ	r ax h i b a
ରହିବାର	r ax h i b aa r a
ରହିଲେ	r ax h i l e
ରହୁଛି	r ax h u ch i
ରହୁନାହିଁ	r ax h u n aa h i mq
ରହୁନି	r ax h u n i
ରାଗ	r aa g a
ରାଗୁଛି	r aa g u ch i
ରାତି	r aa t i
ରାତିଠୁ	r aa t i txh u
ରାତିର	r aa t i r a
ରାତିରେ	r aa t i r e
ରାତିସାରା	r aa t i s aa r aa
ରିଚାର୍ଜ	r i c aa r j a
ରିନିଉ	r i n i u
ରିନିଓ	r i n i o
ରିନୁଆଲ	r i n u aa l a
ରିପୋର୍ଟ	r i p o r tx a
ରିବେଟମେଣ୍ଟ	r i b e tx ax m e nx tx a
ରିହାତି	r i h aa t i
ରୁ	r u
ରୁନ୍ଧି	r u n dh i
ରେ	r e
ରେଗୁଲାର	r e g u l aa r a
ରୋଇବା	r o i b aa
ରୋଈବା	r o ii b aa
ରୋଗ	r o g a
ରୋଗର	r o g ax r a
ରୋଗୀ	r o g ii
ରୋଗୀକୁ	r o g ii k u
ଲଖଣ	l ax kh ax nx a
ଲଗାତାର	l ax g aa t aa r a
ଲଗୁଛି	l ax g u ch i
ଲାଗି	l aa g i
ଲାଗିବ	l aa g i b a
ଲାଗୁଚି	l aa g u c i
ଲାଗୁଛି	l aa g u ch i
ଲାଗୁନି	l aa g u n i
ଲାଗେ	l aa g e
ଲାଳ	l aa lx a
ଲୁକ	l u k a
ଲୁଗା	l u g aa
ଲୁଗାପଟା	l u g aa p ax tx aa
ଲୁହ	l u h a
ଲେଖନ୍ତୁ	l e kh ax n t u
ଲେଖାଏଁ	l e kh aa e mq
ଲେଖିଛନ୍ତି	l e kh i ch ax n t i
ଲେଖିଦିଅନ୍ତୁ	l e kh i d i ax n t u
ଲେଖିଦେଇଥିଲେ	l e kh i d e i th i l e
ଲୋନ୍	l o n
ଵର୍ଷ	w ax r sx a
ଵର୍ଷର	w ax r sx ax r a
ଵସ୍ଛନ୍	w ax s ch ax n
ଵି	w i
ଵୁଝିହୋଉନି	w u jh i h o u n i
ଵ୍ରମଶିର	w r ax m ax sh i r a
ଶକ୍ତ	sh ax k t a
ଶକ୍ତି	sh ax k t i
ଶଙ୍କର	sh ax ng k ax r a
ଶବ୍ଦ	sh ax b d a
ଶଲ୍ୟଚିକିତ୍ସା	sh ax l y ax c i k i t s aa
ଶସ୍ୟକୁ	sh ax s y ax k u
ଶସ୍ୟର	sh ax s y ax r a
ଶହ	sh ax h a
ଶହେ	sh ax h e
ଶିର	sh i r a
ଶିଶୁ	sh i sh u
ଶୀଘ୍ର	sh ii gh r a
ଶୀରା	sh ii r aa
ଶୁଇଯାଉଛି	sh u i j aa u ch i
ଶୁଗାର	sh u g aa r a
ଶୁଭୁ	sh u bh u
ଶୁଭୁଚି	sh u bh u c i
ଶୁଭୁନି	sh u bh u n i
ଶୂଳା	sh uu lx aa
ଶୋଇ	sh o i
ଶୋଇନାହିଁ	sh o i n aa h i mq
ଶୋଇପାରୁନି	sh o i p aa r u n i
ଶୋଇବା	sh o i b aa
ଶୋଇଲା	sh o i l aa
ଷାଠିଏ	sx aa txh i e
ସଇଁ	s ax i mq
ସଁଇ	s ax mq i
ସକାଳୁ	s ax k aa lx u
ସକାଳେ	s ax k aa lx e
ସଂଗେ	s ax N g e
ସତର	s ax t ax r a
ସତୂରୀ	s ax t uu r ii
ସନ୍ଦେହ	s ax n d e h a
ସଂପୂର୍ଣ୍ଣ	s ax N p uu r nx nx a
ସପ୍ତାହକୁ	s ax p t aa h ax k u
ସଫା	s ax ph aa
ସବୁ	s ax b u
ସବୁଆଡେ	s ax b u aa dx e
ସବୁଦିନେ	s ax b u d i n e
ସବୁବେଳ	s ax b u b e lx a
ସବୁବେଳେ	s ax b u b e lx e
ସବ୍ସିଡି	s ax b s i dx i
ସମବାୟ	s ax m ax b aa y a
ସମୟ	s ax m ax y a
ସମୟରେ	s ax m ax y ax r e
ସମସ୍ତ	s ax m ax s t a
ସମସ୍ୟାରୁ	s ax m ax s y aa r u
ସମାନପ୍ରକାର	s ax m aa n ax p r ax k aa r a
ସମିତି	s ax m i t i
ସମ୍ପୂର୍ଣ	s ax m p uu r nx a
ସମ୍ପୂର୍ଣ୍ଣ	s ax m p uu r nx nx a
ସରକାରଙ୍କ	s ax r ax k aa r ax ng k a
ସରକାରୀ	s ax r ax k aa r ii
ସରୁ	s ax r u
ସର୍ଟିଫିକେଟ	s ax r tx i ph i k e tx a
ସର୍ଦ୍ଦି	s ax r d d i
ସର୍ବଦା	s ax r b ax d aa
ସହ	s ax h a
ସହଜ	s ax h ax j a
ସହାୟତା	s ax h aa y ax t aa
ସାଇକେଲ	s aa i k e l a
ସାତ	s aa t a
ସାତମାସର	s aa t ax m aa s ax r a
ସାତରୁ	s aa t ax r u
ସାଥିରେ	s aa th i r e
ସାଧା	s aa dh aa
ସାପ	s aa p a
ସାର	s aa r a
ସାରା	s aa r aa
ସାରି	s aa r i
ସାରିଛି	s aa r i ch i
ସାର୍	s aa r
ସାହାଯ୍ୟ	s aa h aa j y a
ସାହାଯ୍ୟରେ	s aa h aa j y ax r e
ସିଏ	s i e
ସିଙ୍ଗାଣି	s i ng g aa nx i
ସିମିତି	s i m i t i
ସିମ୍	s i m
ସୁଆଦ	s u aa d a
ସୁଧ	s u dh a
ସୁପାରି	s u p aa r i
ସୁପାରୀ	s u p aa r ii
ସୁବିଧା	s u b i dh aa
ସୁଲଭ	s u l ax bh a
ସୁଳା	s u lx aa
ସେ	s e
ସେଇ	s e i
ସେକ୍ସ	s e k s a
ସେଟା	s e tx aa
ସେଥିରେ	s e th i r e
ସେମାନଙ୍କର	s e m aa n ax ng k ax r a
ସେଲାଇନ୍	s e l aa i n
ସେଲ୍	s e l
ସେସବୁ	s e s ax b u
ସୋସାଇଟି	s o s aa i tx i
ସ୍ଖଳନ	s kh ax lx ax n a
ସ୍ଟୋନ	s tx o n a
ସ୍ଟୋନ୍	s tx o n
ସ୍ଟୋର	s tx o r a
ସ୍ତନ	s t ax n a
ସ୍ତରରେ	s t ax r ax r e
ସ୍ତୋନ	s t o n a
ସ୍ତ୍ରୀ	s t r ii
ସ୍ବପ୍ନ	s b ax p n a
ସ୍ରାବ	s r aa b a
ସ୍ୱପ୍ନ	s w ax p n a
ସ୍ୱାଦ	s w aa d a
ସ୍ୱାମୀ	s w aa m ii
ସ୍ୱାମୀଙ୍କର	s w aa m ii ng k ax r a
ହଇଛି	h ax i ch i
ହଇଯାଇଛି	h ax i j aa i ch i
ହଇଯାଉଛି	h ax i j aa u ch i
ହଉ	h ax u
ହଉଚି	h ax u c i
ହଉଛି	h ax u ch i
ହଉଥିଲା	h ax u th i l aa
ହଉନାହି	h ax u n aa h i
ହଉନାହିଁ	h ax u n aa h i mq
ହଉନି	h ax u n i
ହଜମ	h ax j ax m a
ହଜାର	h ax j aa r a
ହଜାରେ	h ax j aa r e
ହଜି	h ax j i
ହଜିଯାଇଛି	h ax j i j aa i ch i
ହଠାତ୍	h ax txh aa t
ହବ	h ax b a
ହବକି	h ax b ax k i
ହବା	h ax b aa
ହଲୁଛି	h ax l u ch i
ହଳଦିଆ	h ax lx ax d i aa
ହଵା	h ax w aa
ହସପିଟାଲ	h ax s ax p i tx aa l a
ହସ୍ପିଟାଲ	h ax s p i tx aa l a
ହାଇ	h aa i
ହାଇଯାଇଛି	h aa i j aa i ch i
ହାକୁଟି	h aa k u tx i
ହାଡ	h aa dx a
ହାଡ଼	h aa dxq a
ହାଡଭଙ୍ଗା	h aa dx ax bh ax ng g aa
ହାଣୁ	h aa nx u
ହାଣ୍ଡିଆ	h aa nx dx i aa
ହାତ	h aa t a
ହାତଟା	h aa t ax tx aa
ହାତରେ	h aa t ax r e
ହାରନିଆ	h aa r ax n i aa
ହାର୍ନିଆ	h aa r n i aa
ହାଲିଆ	h aa l i aa
ହିକା	h i k aa
ହିନତା	h i n ax t aa
ହୁଏ	h u e
ହୁଏନି	h u e n i
ହୁଡ଼ୁ	h u dxq u
ହୂଏକି	h uu e k i
ହୃଦଘାତ	h rq d ax gh aa t a
ହେଇ	h e i
ହେଇକି	h e i k i
ହେଇଗଲା	h e i g ax l aa
ହେଇଗଲାଣି	h e i g ax l aa nx i
ହେଇଚି	h e i c i
ହେଇଛି	h e i ch i
ହେଇଛୁ	h e i ch u
ହେଇଥିବ	h e i th i b a
ହେଇଥିଲା	h e i th i l aa
ହେଇନି	h e i n i
ହେଇପାରିବ	h e i p aa r i b a
ହେଇଯାଇଛି	h e i j aa i ch i
ହେଇଯାଉଚି	h e i j aa u c i
ହେଇଯାଉଛି	h e i j aa u ch i
ହେଇଯିବ	h e i j i b a
ହେଉ	h e u
ହେଉଚି	h e u c i
ହେଉଛି	h e u ch i
ହେଉନାହଁ	h e u n aa h ax mq
ହେଉନାହିଁ	h e u n aa h i mq
ହେଉନି	h e u n i
ହେଊଛି	h e uu ch i
ହେକୁଟୀ	h e k u tx ii
ହେବ	h e b a
ହେବା	h e b aa
ହେବି	h e b i
ହେଲା	h e l aa
ହେଲାକି	h e l aa k i
ହେଲାଣି	h e l aa nx i
ହେଲାନି	h e l aa n i
ହେଲିଣି	h e l i nx i
ହେଲୁଣି	h e l u nx i
ହେଲେ	h e l e
ହେଲ୍ଥ	h e l th a
ହୈ	h ai
ହୋଇ	h o i
ହୋଇକି	h o i k i
ହୋଇଗଲା	h o i g ax l aa
ହୋଇଛି	h o i ch i
ହୋଇଥାନ୍ତେ	h o i th aa n t e
ହୋଇଥିଲା	h o i th i l aa
ହୋଇନାହିଁ	h o i n aa h i mq
ହୋଇପାରିବ	h o i p aa r i b a
ହୋଇଯାଇଛି	h o i j aa i ch i
ହୋଇଯାଉଛି	h e aa i j aa u ch i
ହୋଇଯାଉଛି	h o i j aa u ch i
ହୋଉଛି	h o u ch i
ହୋଉନାହିଁ	h o u n aa h i mq